R 1920 1080
NO textures/CastleWallBlock.xpm
SO textures/CastleBrickBlock_1.xpm
EA textures/BrickBlock_1.xpm
WE textures/UndergroundBrickBlock.xpm

S textures/mario-sprite.xpm
F 10, 10, 10
C 2, 2, X


11111111111111111111111111111
10000000001100000111011111111
11110111111111011100E00010001
11110111111111011101010010001
11000000110101011100000010001
10002000000000001100000010001
11111111111111111111111111111